XXXXXXXXXX
XD k    wX
X        X
X        X
X        X
X     a  X
X    e   X
X      k X
X       DX
XXXXXXXXXX